111111111111111111111111
100000000C000000C0000001
10000E000C000000C000E001
111111111111111111111111
