
1  ./image/arbre.xpm
3  ./image/glasse.xpm

H  ./image/flamme.xpm

F        10,121,2
C        51,255,255


  11111111111111111111111
  11000000000S000000001
  1111111111110000H0001
  300000000000000H00001
  1111111111111111111111