1  ./image/wood.xpm
2  ./image/door.xpm


F        10,1221,2
C        51,255,255


  11111111111111
  10000000000001
  11111111111101
  20000W00000001
  11111111111111