1111111111111
1000000000111
1111111110001
111111111EP01
1111111111101
