1111111111111
1110000000001
1111111111001
1000000000011
1PE0000000011
11111111111111
