111111111111111111111111
10000P000C000000C0000001
100000000C000000C0000001
111111111111111111111111
