111111111111111111111111
10000P000C000000C0000001
10000E000P000000C0000001
111111111111111111111111
