111111111111111111111111
1F000P000C000000C0000001
10030E000C000000C0000001
111111111111111111111111
