111111111111111111111111
10000P000000000000000001
10000E000000000000000001
111111111111111111111111
